GUID,GEOGID,GEOGDESC,T3_1YES,T3_1NO,T3_1NS,T3_1T,T3_2DIM,T3_2DIDOM,T3_2DIWOM,T3_2DILOOM,T3_2DINOM,T3_2DOESM,T3_2WOESM,T3_2LOOESM,T3_2NOESM,T3_2NSM,T3_2ALLM,T3_2DIF,T3_2DIDOF,T3_2DIWOF,T3_2DILOOF,T3_2DINOF,T3_2DOESF,T3_2WOESF,T3_2LOOESF,T3_2NOESF,T3_2NSF,T3_2ALLF,T3_2DIT,T3_2DIDOT,T3_2DIWOT,T3_2DILOOT,T3_2DINOT,T3_2DOEST,T3_2WOEST,T3_2LOOEST,T3_2NOEST,T3_2NST,T3_2ALLT
2AE19629235A13A3E055000000000001,ED3409_26001,Ballybaan,"3,877","7,703",691,"12,271",640,22,14,7,1,80,122,525,274,15,"1,700",750,17,8,6,5,98,148,673,438,34,"2,177","1,390",39,22,13,6,178,270,"1,198",712,49,"3,877"
2AE19629235B13A3E055000000000001,ED3409_26002,Baile an Bhriotaihg,338,538,39,915,37,2,0,0,0,11,11,48,44,1,154,33,6,0,0,0,6,11,69,58,1,184,70,8,0,0,0,17,22,117,102,2,338
2AE19629235C13A3E055000000000001,ED3409_26003,Bearna,"7,239","6,904",318,"14,461","1,002",70,16,9,3,237,252,"1,050",467,24,"3,130","1,250",115,17,10,3,275,348,"1,422",645,24,"4,109","2,252",185,33,19,6,512,600,"2,472","1,112",48,"7,239"
2AE19629235D13A3E055000000000001,ED3409_26004,An Caisle�n Gearr,"1,394","2,344",156,"3,894",135,7,1,2,0,39,56,262,129,6,637,194,12,2,1,0,44,61,283,155,5,757,329,19,3,3,0,83,117,545,284,11,"1,394"
2AE19629235E13A3E055000000000001,ED3409_26005,Claddagh,"1,116","1,345",90,"2,551",69,1,2,1,0,37,69,204,99,5,487,87,9,2,2,0,40,66,279,137,7,629,156,10,4,3,0,77,135,483,236,12,"1,116"
2AE19629235F13A3E055000000000001,ED3409_26006,Dangan,"1,903","2,028",90,"4,021",116,6,0,4,1,36,76,361,180,6,786,176,14,4,1,0,40,104,507,264,7,"1,117",292,20,4,5,1,76,180,868,444,13,"1,903"
2AE19629236013A3E055000000000001,ED3409_26007,Eyre Square,"1,225","2,601",248,"4,074",35,1,1,0,1,46,57,235,153,9,538,64,5,1,1,1,29,60,324,198,4,687,99,6,2,1,2,75,117,559,351,13,"1,225"
2AE19629236113A3E055000000000001,ED3409_26008,An Cnoc�n Carrach,783,652,18,"1,453",62,3,0,0,1,31,34,132,77,1,341,82,6,0,0,0,25,40,193,96,0,442,144,9,0,0,1,56,74,325,173,1,783
2AE19629236F13A3E055000000000001,ED3409_26009,Lough Atalia,439,385,53,877,39,4,1,0,0,22,21,69,30,0,186,59,5,1,0,0,16,26,102,43,1,253,98,9,2,0,0,38,47,171,73,1,439
2AE19629237013A3E055000000000001,ED3409_26010,Mionlach,"2,148","2,631",181,"4,960",163,9,3,1,0,59,98,384,220,8,945,236,14,4,1,0,60,110,494,278,6,"1,203",399,23,7,2,0,119,208,878,498,14,"2,148"
2AE19629237113A3E055000000000001,ED3409_26011,Mervue,587,"1,005",201,"1,793",44,4,0,1,0,10,20,117,64,2,262,51,4,0,0,0,23,21,139,81,6,325,95,8,0,1,0,33,41,256,145,8,587
2AE19629237213A3E055000000000001,ED3409_26012,Murroogh,"1,005","1,569",169,"2,743",86,5,0,0,0,20,40,202,91,6,450,130,10,0,0,0,27,39,215,126,8,555,216,15,0,0,0,47,79,417,217,14,"1,005"
2AE19629237313A3E055000000000001,ED3409_26013,Newcastle,675,"1,136",41,"1,852",41,1,1,0,0,10,33,128,63,5,282,52,1,0,2,0,18,42,169,107,2,393,93,2,1,2,0,28,75,297,170,7,675
2AE19629237413A3E055000000000001,ED3409_26014,Nuns Island,590,793,53,"1,436",23,3,1,0,0,18,27,102,57,2,233,38,6,0,0,0,24,29,182,76,2,357,61,9,1,0,0,42,56,284,133,4,590
2AE19629237513A3E055000000000001,ED3409_26015,Rahoon,"1,260","1,642",44,"2,946",156,6,2,0,2,30,51,203,86,4,540,174,9,4,1,2,39,65,286,138,2,720,330,15,6,1,4,69,116,489,224,6,"1,260"
2AE19629237613A3E055000000000001,ED3409_26016,Renmore,624,608,51,"1,283",58,4,0,0,0,23,26,123,35,4,273,74,4,1,0,0,13,28,154,76,1,351,132,8,1,0,0,36,54,277,111,5,624
2AE19629237713A3E055000000000001,ED3409_26017,Rockbarton,"1,036",932,92,"2,060",109,6,1,1,0,28,46,191,84,4,470,91,5,1,1,0,22,55,257,128,6,566,200,11,2,2,0,50,101,448,212,10,"1,036"
2AE19629238413A3E055000000000001,ED3409_26018,Par�iste San Nicol�is,776,"1,462",124,"2,362",26,2,0,0,0,33,41,160,91,4,357,35,2,1,0,1,27,22,198,128,5,419,61,4,1,0,1,60,63,358,219,9,776
2AE19629238213A3E055000000000001,ED3409_26019,Salthill,"1,562","1,820",119,"3,501",135,14,1,1,1,42,79,282,145,8,708,151,11,3,2,0,46,81,370,181,9,854,286,25,4,3,1,88,160,652,326,17,"1,562"
2AE19629238313A3E055000000000001,ED3409_26020,Shantalla,656,987,193,"1,836",32,4,0,0,0,22,24,141,55,4,282,46,4,1,0,0,18,37,199,68,1,374,78,8,1,0,0,40,61,340,123,5,656
2AE19629238513A3E055000000000001,ED3409_26021,Taylors Hill,"1,374","1,436",71,"2,881",155,6,2,3,0,54,79,227,100,1,627,195,13,3,3,2,37,80,284,121,9,747,350,19,5,6,2,91,159,511,221,10,"1,374"
2AE19629238613A3E055000000000001,ED3409_26022,Wellpark,533,"1,021",75,"1,629",32,4,0,0,0,11,21,122,57,2,249,40,4,2,0,0,9,26,124,78,1,284,72,8,2,0,0,20,47,246,135,3,533
2AE19629205D13A3E055000000000001,ED3409_27001,Ballinasloe Urban,"2,414","3,724",171,"6,309",361,7,2,2,3,16,61,391,227,8,"1,078",410,12,2,3,2,30,85,495,286,11,"1,336",771,19,4,5,5,46,146,886,513,19,"2,414"
2AE19629210113A3E055000000000001,ED3409_27002,Abbeygormacan,164,213,8,385,26,0,0,0,0,0,2,28,19,0,75,31,0,0,1,0,0,2,36,19,0,89,57,0,0,1,0,0,4,64,38,0,164
2AE19629204713A3E055000000000001,ED3409_27003,Ahascragh,266,306,14,586,34,1,0,1,0,0,8,38,48,3,133,28,1,0,0,0,4,9,48,41,2,133,62,2,0,1,0,4,17,86,89,5,266
2AE19629205213A3E055000000000001,ED3409_27004,Aughrim,258,294,4,556,34,0,1,0,0,0,9,40,26,1,111,46,1,0,0,1,3,13,49,33,1,147,80,1,1,0,1,3,22,89,59,2,258
2AE19629205C13A3E055000000000001,ED3409_27005,Ballinasloe Rural,295,249,11,555,34,4,2,0,1,6,10,51,31,0,139,52,2,0,0,1,5,9,60,27,0,156,86,6,2,0,2,11,19,111,58,0,295
2AE19629207613A3E055000000000001,ED3409_27006,Ballymacward,151,146,0,297,25,3,0,0,0,1,2,26,16,0,73,13,1,0,0,0,2,5,40,17,0,78,38,4,0,0,0,3,7,66,33,0,151
2AE19629210513A3E055000000000001,ED3409_27007,Clonfert,164,239,7,410,18,0,0,0,1,1,4,24,24,1,73,29,2,0,0,0,0,6,30,24,0,91,47,2,0,0,1,1,10,54,48,1,164
2AE19629204813A3E055000000000001,ED3409_27008,Clontuskert,87,112,8,207,7,0,0,0,0,2,0,21,13,0,43,6,0,0,0,0,1,3,25,8,1,44,13,0,0,0,0,3,3,46,21,1,87
2AE19629237B13A3E055000000000001,ED3409_27009,Kellysgrove,165,175,9,349,13,3,1,0,0,2,6,23,16,1,65,24,3,0,0,0,2,11,41,18,1,100,37,6,1,0,0,4,17,64,34,2,165
2AE19629239813A3E055000000000001,ED3409_27010,Kilconnell,284,356,9,649,21,1,1,0,1,5,6,55,24,1,115,53,0,0,0,0,3,12,57,42,2,169,74,1,1,0,1,8,18,112,66,3,284
2AE1962923A613A3E055000000000001,ED3409_27011,Killaan,227,273,3,503,32,0,0,1,0,4,4,30,30,0,101,48,0,0,0,0,3,6,36,33,0,126,80,0,0,1,0,7,10,66,63,0,227
2AE1962923A713A3E055000000000001,ED3409_27012,Killallaghtan,214,207,19,440,36,0,0,0,0,0,1,32,39,0,108,21,1,0,0,0,3,5,43,33,0,106,57,1,0,0,0,3,6,75,72,0,214
2AE1962922F713A3E055000000000001,ED3409_27013,Killoran,112,132,11,255,23,0,0,0,0,0,1,15,17,0,56,15,0,0,0,0,0,4,17,20,0,56,38,0,0,0,0,0,5,32,37,0,112
2AE19629230613A3E055000000000001,ED3409_27014,Killure,308,386,8,702,58,0,0,2,1,1,5,37,33,0,137,45,0,0,0,0,2,17,63,43,1,171,103,0,0,2,1,3,22,100,76,1,308
2AE19629231613A3E055000000000001,ED3409_27015,Kilmacshane,89,129,7,225,14,0,0,0,0,0,4,8,11,1,38,21,0,0,0,0,0,3,13,13,1,51,35,0,0,0,0,0,7,21,24,2,89
2AE19629233D13A3E055000000000001,ED3409_27016,Kiltormer,185,267,21,473,18,0,0,0,1,0,2,30,22,2,75,23,0,0,1,0,1,6,48,26,5,110,41,0,0,1,1,1,8,78,48,7,185
2AE19629234D13A3E055000000000001,ED3409_27017,Kylemore,58,87,3,148,4,0,1,0,0,0,2,10,6,0,23,10,0,1,0,0,0,2,13,8,1,35,14,0,2,0,0,0,4,23,14,1,58
2AE19629235813A3E055000000000001,ED3409_27018,Laurencetown,115,220,4,339,14,0,0,0,1,0,3,21,14,1,54,16,0,0,0,0,1,2,25,17,0,61,30,0,0,0,1,1,5,46,31,1,115
2AE19629238013A3E055000000000001,ED3409_27019,Lismanny,107,135,3,245,10,1,0,0,0,4,3,20,9,0,47,19,3,0,0,0,0,8,23,6,1,60,29,4,0,0,0,4,11,43,15,1,107
2AE1962922DE13A3E055000000000001,ED3409_27020,Oatfield,209,197,8,414,28,0,1,1,0,3,2,37,14,1,87,47,0,0,0,0,4,4,45,21,1,122,75,0,1,1,0,7,6,82,35,2,209
2AE19629208C13A3E055000000000001,ED3409_27021,Ballynakill,105,303,21,429,10,0,0,0,0,3,4,15,5,0,37,22,0,0,0,0,4,4,20,16,2,68,32,0,0,0,0,7,8,35,21,2,105
2AE1962920A613A3E055000000000001,ED3409_27022,Binn an Choire,52,146,25,223,3,0,0,0,0,2,1,15,3,1,25,0,0,0,0,0,1,6,18,2,0,27,3,0,0,0,0,3,7,33,5,1,52
2AE1962920B113A3E055000000000001,ED3409_27023,Bunowen,120,267,19,406,12,0,0,0,0,3,4,19,12,1,51,18,0,1,0,0,0,4,28,16,2,69,30,0,1,0,0,3,8,47,28,3,120
2AE1962920F413A3E055000000000001,ED3409_27024,Cleggan,80,182,6,268,8,0,0,0,0,2,4,20,2,0,36,9,0,0,0,0,0,2,23,10,0,44,17,0,0,0,0,2,6,43,12,0,80
2AE1962920F513A3E055000000000001,ED3409_27025,Clifden,674,"1,333",88,"2,095",79,2,0,1,0,21,30,137,46,1,317,106,1,2,3,1,13,29,140,61,1,357,185,3,2,4,1,34,59,277,107,2,674
2AE19629230013A3E055000000000001,ED3409_27026,Cushkillary,116,189,10,315,22,0,0,0,0,1,13,15,6,1,58,33,0,0,0,0,5,7,13,0,0,58,55,0,0,0,0,6,20,28,6,1,116
2AE19629231413A3E055000000000001,ED3409_27029,Doonloughan,22,51,9,82,5,0,0,0,0,0,1,2,3,0,11,3,0,0,0,0,0,2,4,2,0,11,8,0,0,0,0,0,3,6,5,0,22
2AE19629232C13A3E055000000000001,ED3409_27030,Errislannan,61,138,13,212,8,0,0,0,0,0,3,12,1,0,24,12,0,1,0,0,1,0,14,9,0,37,20,0,1,0,0,1,3,26,10,0,61
2AE19629236713A3E055000000000001,ED3409_27031,An Uillinn,70,21,1,92,11,0,0,0,0,10,9,13,1,0,44,6,0,0,0,0,5,4,8,3,0,26,17,0,0,0,0,15,13,21,4,0,70
2AE19629236813A3E055000000000001,ED3409_27032,Inishbofin,43,110,15,168,3,1,0,0,0,2,0,5,7,0,18,7,0,0,0,0,0,3,11,4,0,25,10,1,0,0,0,2,3,16,11,0,43
2AE19629234C13A3E055000000000001,ED3409_27033,An Cnoc Bu�,692,78,9,779,71,41,2,0,0,191,13,12,3,2,335,82,40,3,0,0,186,22,18,3,3,357,153,81,5,0,0,377,35,30,6,5,692
2AE1962922DD13A3E055000000000001,ED3409_27034,Ma�ros,178,159,5,342,16,1,1,0,0,9,13,40,5,2,87,9,5,0,0,0,12,15,38,12,0,91,25,6,1,0,0,21,28,78,17,2,178
2AE1962922E113A3E055000000000001,ED3409_27035,Abhainn Ghabhla,231,22,4,257,20,11,0,0,0,77,10,11,1,3,133,18,12,0,0,0,52,7,6,0,3,98,38,23,0,0,0,129,17,17,1,6,231
2AE1962922FA13A3E055000000000001,ED3409_27036,Rinvyle,354,810,24,"1,188",42,1,0,1,0,6,14,66,25,2,157,62,6,0,0,0,10,13,70,35,1,197,104,7,0,1,0,16,27,136,60,3,354
2AE1962922FC13A3E055000000000001,ED3409_27037,Cloch na R�n,154,250,7,411,17,0,0,0,0,0,6,35,11,1,70,14,0,0,0,0,8,10,34,16,2,84,31,0,0,0,0,8,16,69,27,3,154
2AE19629230B13A3E055000000000001,ED3409_27038,Sillerna,119,259,4,382,12,0,0,0,0,3,6,20,13,0,54,13,0,0,0,0,3,3,33,12,1,65,25,0,0,0,0,6,9,53,25,1,119
2AE19629230C13A3E055000000000001,ED3409_27039,Scainimh,556,38,8,602,48,32,1,0,0,179,14,7,1,4,286,58,55,1,1,0,136,11,8,0,0,270,106,87,2,1,0,315,25,15,1,4,556
2AE19629204F13A3E055000000000001,ED3409_27040,Eanach Dh�in,995,783,33,"1,811",150,6,0,1,0,24,42,183,82,2,490,146,9,2,0,0,18,51,175,99,5,505,296,15,2,1,0,42,93,358,181,7,995
2AE19629205113A3E055000000000001,ED3409_27041,Aughrim,600,626,13,"1,239",106,4,0,0,0,9,12,90,61,2,284,105,0,2,0,0,8,19,111,69,2,316,211,4,2,0,0,17,31,201,130,4,600
2AE19629206913A3E055000000000001,ED3409_27042,Baile an Teampaill (Part Rural),714,694,16,"1,424",84,5,1,0,3,17,17,111,76,4,318,110,7,2,1,0,12,32,146,84,2,396,194,12,3,1,3,29,49,257,160,6,714
2AE19629207F13A3E055000000000001,ED3409_27043,Ballynacourty,646,479,12,"1,137",64,0,1,4,1,3,15,133,77,3,301,97,1,0,3,0,4,23,142,74,1,345,161,1,1,7,1,7,38,275,151,4,646
2AE19629209813A3E055000000000001,ED3409_27044,Bearna (Part Rural),"2,358","1,168",60,"3,586",337,18,6,4,1,95,97,421,147,10,"1,136",376,20,10,2,1,96,119,428,161,9,"1,222",713,38,16,6,2,191,216,849,308,19,"2,358"
2AE1962920A513A3E055000000000001,ED3409_27045,Belleville,231,324,29,584,30,0,1,0,0,2,1,33,36,0,103,33,0,2,0,0,3,5,51,32,2,128,63,0,3,0,0,5,6,84,68,2,231
2AE1962920CB13A3E055000000000001,ED3409_27046,An Carn M�r,"1,436","1,007",35,"2,478",195,5,1,0,1,23,56,278,132,3,694,217,5,6,3,0,24,51,296,134,6,742,412,10,7,3,1,47,107,574,266,9,"1,436"
2AE1962920CC13A3E055000000000001,ED3409_27047,Ceathr� an Bhr�naigh (Part Rural),500,422,16,938,53,4,1,1,0,19,30,89,33,1,231,77,6,1,1,1,14,26,105,37,1,269,130,10,2,2,1,33,56,194,70,2,500
2AE1962920E213A3E055000000000001,ED3409_27048,Baile Chl�ir,"1,061",928,41,"2,030",153,6,4,1,1,17,39,204,82,4,511,169,8,3,2,1,24,49,194,98,2,550,322,14,7,3,2,41,88,398,180,6,"1,061"
2AE1962920F313A3E055000000000001,ED3409_27049,Clarinbridge,"1,749","1,541",43,"3,333",261,10,3,5,4,34,61,281,159,2,820,278,9,5,2,1,39,57,337,196,5,929,539,19,8,7,5,73,118,618,355,7,"1,749"
2AE19629230113A3E055000000000001,ED3409_27050,Deerpark,560,742,56,"1,358",88,2,1,0,1,6,19,73,67,2,259,105,1,1,4,1,6,20,105,56,2,301,193,3,2,4,2,12,39,178,123,4,560
2AE19629233813A3E055000000000001,ED3409_27051,Na Forbacha,925,413,24,"1,362",123,24,0,1,1,118,63,111,12,2,455,120,20,2,0,1,100,59,131,31,6,470,243,44,2,1,2,218,122,242,43,8,925
2AE19629233913A3E055000000000001,ED3409_27052,Galway Rural (Part Rural),72,74,0,146,9,1,0,0,0,5,2,13,4,0,34,5,1,0,0,0,3,4,18,7,0,38,14,2,0,0,0,8,6,31,11,0,72
2AE19629236913A3E055000000000001,ED3409_27053,�rainn,996,172,19,"1,187",119,58,1,0,0,298,23,15,2,3,519,104,62,0,0,0,263,15,26,3,4,477,223,120,1,0,0,561,38,41,5,7,996
2AE1962923A513A3E055000000000001,ED3409_27054,Cill Chuimin,"1,145",100,22,"1,267",126,57,2,0,0,337,18,20,0,11,571,124,64,0,1,0,318,41,19,1,6,574,250,121,2,1,0,655,59,39,1,17,"1,145"
2AE1962923A813A3E055000000000001,ED3409_27055,Cill Aithn�n,877,132,3,"1,012",79,52,0,0,0,239,31,26,3,6,436,86,82,2,0,0,191,36,31,5,8,441,165,134,2,0,0,430,67,57,8,14,877
2AE19629234E13A3E055000000000001,ED3409_27056,Leacach Beag,729,701,22,"1,452",124,5,2,0,2,3,20,107,69,2,334,113,3,3,1,1,15,28,149,81,1,395,237,8,5,1,3,18,48,256,150,3,729
2AE19629237E13A3E055000000000001,ED3409_27057,Liscananaun,680,786,11,"1,477",83,1,0,0,0,14,23,136,70,2,329,109,1,2,0,1,16,22,120,79,1,351,192,2,2,0,1,30,45,256,149,3,680
2AE19629237F13A3E055000000000001,ED3409_27058,Lis�n an Bhealaigh,504,486,22,"1,012",83,3,0,0,0,5,9,67,60,0,227,99,0,2,0,1,7,16,90,59,3,277,182,3,2,0,1,12,25,157,119,3,504
2AE1962922D113A3E055000000000001,ED3409_27059,Maigh Cuilinn,"1,240",801,16,"2,057",174,15,2,1,0,40,67,226,79,3,607,173,17,5,0,2,54,68,236,75,3,633,347,32,7,1,2,94,135,462,154,6,"1,240"
2AE1962922DF13A3E055000000000001,ED3409_27060,Oranmore,"1,887","2,126",78,"4,091",273,9,3,1,0,22,50,303,175,2,838,356,6,3,2,1,36,87,351,202,5,"1,049",629,15,6,3,1,58,137,654,377,7,"1,887"
2AE19629230913A3E055000000000001,ED3409_27061,Sailearna,"1,246",146,13,"1,405",123,94,1,0,0,315,38,27,2,6,606,132,116,2,0,0,318,33,30,2,7,640,255,210,3,0,0,633,71,57,4,13,"1,246"
2AE19629231913A3E055000000000001,ED3409_27062,Sliabh an Aonaigh,530,205,3,738,64,4,0,0,0,40,30,102,16,2,258,57,7,2,0,0,36,43,99,24,4,272,121,11,2,0,0,76,73,201,40,6,530
2AE19629231A13A3E055000000000001,ED3409_27063,An Spid�al,"1,160",219,14,"1,393",122,70,0,0,0,256,60,55,8,5,576,126,76,1,0,1,257,39,68,11,5,584,248,146,1,0,1,513,99,123,19,10,"1,160"
2AE19629232613A3E055000000000001,ED3409_27064,Stradbally,630,539,11,"1,180",119,1,0,0,2,7,20,93,58,0,300,115,1,0,0,2,10,16,116,67,3,330,234,2,0,0,4,17,36,209,125,3,630
2AE19629234013A3E055000000000001,ED3409_27065,Tulaigh Mhic Aodh�in,"1,144",813,28,"1,985",140,6,3,3,1,41,68,169,78,1,510,183,16,4,5,0,45,73,220,86,2,634,323,22,7,8,1,86,141,389,164,3,"1,144"
2AE19629205E13A3E055000000000001,ED3409_27066,Ballinastack,114,200,10,324,10,0,0,0,0,0,0,17,24,2,53,15,0,0,0,0,1,1,24,20,0,61,25,0,0,0,0,1,1,41,44,2,114
2AE19629207E13A3E055000000000001,ED3409_27067,Ballymoe,180,215,6,401,19,0,0,0,0,2,4,36,22,0,83,32,0,0,0,0,2,8,34,19,2,97,51,0,0,0,0,4,12,70,41,2,180
2AE19629208D13A3E055000000000001,ED3409_27068,Ballynakill,160,205,4,369,12,0,0,0,0,0,3,32,22,0,69,19,0,0,0,0,0,4,48,20,0,91,31,0,0,0,0,0,7,80,42,0,160
2AE1962920A713A3E055000000000001,ED3409_27069,Boyounagh,136,109,1,246,17,0,0,0,0,1,2,22,20,0,62,24,0,0,0,0,0,3,32,15,0,74,41,0,0,0,0,1,5,54,35,0,136
2AE1962922F013A3E055000000000001,ED3409_27070,Creggs,135,213,4,352,20,0,0,0,0,1,1,20,20,0,62,16,0,0,0,0,1,6,30,18,2,73,36,0,0,0,0,2,7,50,38,2,135
2AE1962922FF13A3E055000000000001,ED3409_27071,Curraghmore,66,94,1,161,10,0,0,0,0,0,2,10,8,0,30,13,0,0,0,0,0,1,12,10,0,36,23,0,0,0,0,0,3,22,18,0,66
2AE19629233A13A3E055000000000001,ED3409_27072,Glennamaddy,321,467,15,803,40,1,0,1,0,2,9,62,28,0,143,43,1,0,0,1,3,18,69,42,1,178,83,2,0,1,1,5,27,131,70,1,321
2AE19629236A13A3E055000000000001,ED3409_27073,Island,109,133,3,245,12,1,0,0,0,0,2,23,18,0,56,17,0,1,0,0,0,2,16,17,0,53,29,1,1,0,0,0,4,39,35,0,109
2AE1962923A313A3E055000000000001,ED3409_27074,Kilcroan,256,265,9,530,23,1,1,1,0,2,5,50,28,2,113,39,0,1,0,0,1,6,60,35,1,143,62,1,2,1,0,3,11,110,63,3,256
2AE19629234A13A3E055000000000001,ED3409_27075,Kiltullagh,79,133,0,212,6,1,0,1,0,1,2,13,11,0,35,15,1,0,0,0,1,0,16,11,0,44,21,2,0,1,0,2,2,29,22,0,79
2AE1962922F913A3E055000000000001,ED3409_27076,Raheen,155,284,16,455,24,0,0,0,0,0,2,26,15,1,68,33,0,0,2,0,0,2,27,23,0,87,57,0,0,2,0,0,4,53,38,1,155
2AE19629230813A3E055000000000001,ED3409_27077,Scregg,120,101,2,223,14,0,0,0,0,0,1,20,21,0,56,22,0,0,0,0,1,1,25,15,0,64,36,0,0,0,0,1,2,45,36,0,120
2AE19629230A13A3E055000000000001,ED3409_27078,Shankill,122,157,4,283,13,0,1,0,0,2,4,22,7,0,49,19,0,0,0,0,2,5,29,17,1,73,32,0,1,0,0,4,9,51,24,1,122
2AE19629232813A3E055000000000001,ED3409_27079,Templetogher,159,205,5,369,12,0,0,0,0,1,2,30,28,1,74,24,0,1,0,0,1,3,29,26,1,85,36,0,1,0,0,2,5,59,54,2,159
2AE19629233513A3E055000000000001,ED3409_27080,Toberroe,136,155,2,293,21,0,0,2,0,3,3,19,16,0,64,16,1,0,1,0,2,5,30,17,0,72,37,1,0,3,0,5,8,49,33,0,136
2AE19629205A13A3E055000000000001,ED3409_27081,Ardamullivan,245,321,12,578,28,1,1,0,0,4,3,44,24,0,105,39,2,1,0,0,4,5,58,29,2,140,67,3,2,0,0,8,8,102,53,2,245
2AE19629205B13A3E055000000000001,ED3409_27082,Ardrahan,263,275,10,548,47,0,0,1,0,1,12,35,30,0,126,41,1,0,0,0,4,3,49,38,1,137,88,1,0,1,0,5,15,84,68,1,263
2AE19629207413A3E055000000000001,ED3409_27083,Ballycahalan,81,129,1,211,15,0,0,0,0,0,4,13,4,1,37,18,0,0,1,0,0,3,13,9,0,44,33,0,0,1,0,0,7,26,13,1,81
2AE19629209913A3E055000000000001,ED3409_27084,Beagh,283,374,14,671,28,1,0,1,0,2,10,46,41,2,131,41,3,4,1,0,2,14,54,32,1,152,69,4,4,2,0,4,24,100,73,3,283
2AE1962920B213A3E055000000000001,ED3409_27085,Cahermore,256,238,9,503,42,0,0,0,0,3,3,41,31,0,120,43,0,0,1,0,4,8,51,28,1,136,85,0,0,1,0,7,11,92,59,1,256
2AE1962920C013A3E055000000000001,ED3409_27086,Cappard,31,61,1,93,5,1,0,0,0,1,2,5,3,0,17,1,2,0,0,0,0,1,7,3,0,14,6,3,0,0,0,1,3,12,6,0,31
2AE1962920E113A3E055000000000001,ED3409_27087,Castletaylor,290,300,6,596,45,1,0,0,1,2,8,46,26,1,130,51,0,0,0,0,8,11,58,30,2,160,96,1,0,0,1,10,19,104,56,3,290
2AE19629231E13A3E055000000000001,ED3409_27088,Doorus,373,404,3,780,63,4,0,0,1,7,10,57,32,0,174,71,2,0,0,0,9,10,68,38,1,199,134,6,0,0,1,16,20,125,70,1,373
2AE19629231F13A3E055000000000001,ED3409_27089,Drumacoo,572,743,8,"1,323",70,0,1,1,0,4,23,92,53,3,247,108,3,0,1,0,5,22,117,66,3,325,178,3,1,2,0,9,45,209,119,6,572
2AE19629234513A3E055000000000001,ED3409_27090,Gort,943,"1,831",119,"2,893",130,2,2,1,1,17,18,128,99,4,402,171,3,1,1,0,26,35,184,115,5,541,301,5,3,2,1,43,53,312,214,9,943
2AE19629237C13A3E055000000000001,ED3409_27091,Kilbeacanty,138,169,4,311,17,0,0,1,0,1,4,22,12,2,59,25,1,0,0,0,2,7,26,18,0,79,42,1,0,1,0,3,11,48,30,2,138
2AE1962922CE13A3E055000000000001,ED3409_27092,Killeely,796,848,7,"1,651",130,3,0,0,0,8,35,121,87,2,386,125,4,4,0,0,7,29,162,75,4,410,255,7,4,0,0,15,64,283,162,6,796
2AE1962922DA13A3E055000000000001,ED3409_27093,Killeenavarra,356,400,8,764,71,0,0,0,2,4,12,51,28,0,168,72,4,0,0,2,8,7,65,30,0,188,143,4,0,0,4,12,19,116,58,0,356
2AE1962922F513A3E055000000000001,ED3409_27094,Killinny,176,255,3,434,21,0,0,0,1,2,5,41,17,1,88,28,1,1,0,0,1,2,40,14,1,88,49,1,1,0,1,3,7,81,31,2,176
2AE19629233113A3E055000000000001,ED3409_27095,Kiltartan,373,393,27,793,51,1,0,3,0,1,6,61,38,3,164,68,2,0,1,0,6,17,67,48,0,209,119,3,0,4,0,7,23,128,86,3,373
2AE19629233C13A3E055000000000001,ED3409_27096,Kilthomas,36,41,2,79,5,0,0,0,0,0,1,8,4,0,18,4,0,0,0,0,0,0,9,3,2,18,9,0,0,0,0,0,1,17,7,2,36
2AE19629234B13A3E055000000000001,ED3409_27097,Kinvarra,681,750,30,"1,461",78,0,1,0,1,9,20,123,69,2,303,120,4,0,1,0,15,17,130,89,2,378,198,4,1,1,1,24,37,253,158,4,681
2AE1962922F813A3E055000000000001,ED3409_27098,Rahasane,180,144,4,328,25,1,0,0,0,3,3,34,17,0,83,24,0,0,0,0,3,6,43,21,0,97,49,1,0,0,0,6,9,77,38,0,180
2AE19629231813A3E055000000000001,ED3409_27099,Skehanagh,241,208,4,453,32,0,0,1,0,2,8,46,19,1,109,43,0,1,0,0,4,6,51,25,2,132,75,0,1,1,0,6,14,97,44,3,241
2AE19629204D13A3E055000000000001,ED3409_27100,Aille,197,176,4,377,32,1,1,0,0,3,5,26,27,3,98,29,3,0,0,0,2,6,29,29,1,99,61,4,1,0,0,5,11,55,56,4,197
2AE19629205013A3E055000000000001,ED3409_27101,Athenry,"2,128","2,888",125,"5,141",373,24,4,3,2,33,50,319,134,3,945,427,23,6,2,0,36,86,396,197,10,"1,183",800,47,10,5,2,69,136,715,331,13,"2,128"
2AE19629208013A3E055000000000001,ED3409_27102,Ballynagar,70,111,8,189,9,0,0,1,0,0,0,12,8,0,30,15,0,0,0,0,0,0,16,9,0,40,24,0,0,1,0,0,0,28,17,0,70
2AE1962920AF13A3E055000000000001,ED3409_27103,Bracklagh,192,249,7,448,34,0,2,0,0,0,6,26,23,3,94,30,0,0,0,0,1,6,42,19,0,98,64,0,2,0,0,1,12,68,42,3,192
2AE1962920B013A3E055000000000001,ED3409_27104,Bullaun,117,153,19,289,22,1,1,0,0,1,5,20,8,0,58,16,1,0,0,0,1,8,18,15,0,59,38,2,1,0,0,2,13,38,23,0,117
2AE1962920BF13A3E055000000000001,ED3409_27105,Cappalusk,177,186,5,368,35,1,0,0,0,3,4,34,14,0,91,26,0,0,0,0,2,6,30,20,2,86,61,1,0,0,0,5,10,64,34,2,177
2AE1962920D813A3E055000000000001,ED3409_27106,Castleboy,251,262,4,517,37,0,3,1,3,1,9,22,45,1,122,30,1,4,0,1,3,7,42,40,1,129,67,1,7,1,4,4,16,64,85,2,251
2AE19629205313A3E055000000000001,ED3409_27107,Cloonkeen,176,267,6,449,29,0,2,0,0,1,4,24,17,0,77,33,6,1,1,0,0,6,30,21,1,99,62,6,3,1,0,1,10,54,38,1,176
2AE19629205513A3E055000000000001,ED3409_27108,Colmanstown,54,73,0,127,3,1,0,0,0,1,2,14,7,0,28,8,0,0,0,0,0,3,11,4,0,26,11,1,0,0,0,1,5,25,11,0,54
2AE1962922E713A3E055000000000001,ED3409_27109,Craughwell,824,829,46,"1,699",130,1,1,1,0,10,31,126,86,0,386,157,0,2,0,2,7,26,154,88,2,438,287,1,3,1,2,17,57,280,174,2,824
2AE19629231013A3E055000000000001,ED3409_27110,Derrylaur,42,57,2,101,7,0,0,0,0,0,1,5,5,0,18,3,1,0,0,0,1,3,12,4,0,24,10,1,0,0,0,1,4,17,9,0,42
2AE19629232013A3E055000000000001,ED3409_27111,Drumkeary,253,300,9,562,28,0,0,1,1,1,7,50,38,1,127,33,0,1,1,0,4,9,47,29,2,126,61,0,1,2,1,5,16,97,67,3,253
2AE19629234713A3E055000000000001,ED3409_27112,Graigabbey,162,201,1,364,33,0,0,0,0,2,3,22,9,0,69,37,0,0,0,0,5,2,38,10,1,93,70,0,0,0,0,7,5,60,19,1,162
2AE19629234813A3E055000000000001,ED3409_27113,Grange,327,385,14,726,47,0,0,0,0,0,6,50,47,2,152,60,1,0,0,0,4,9,71,29,1,175,107,1,0,0,0,4,15,121,76,3,327
2AE19629235413A3E055000000000001,ED3409_27114,Greethill,530,409,12,951,92,3,0,2,0,3,10,84,62,4,260,85,5,0,3,0,4,16,105,52,0,270,177,8,0,5,0,7,26,189,114,4,530
2AE19629238B13A3E055000000000001,ED3409_27115,Kilchreest,162,126,8,296,22,0,0,0,0,4,8,26,21,1,82,25,0,1,0,0,6,3,27,18,0,80,47,0,1,0,0,10,11,53,39,1,162
2AE19629238C13A3E055000000000001,ED3409_27116,Kilconickny,304,328,20,652,52,0,0,0,0,4,1,45,31,2,135,66,2,0,0,0,3,9,52,37,0,169,118,2,0,0,0,7,10,97,68,2,304
2AE19629239713A3E055000000000001,ED3409_27117,Kilconierin,267,264,7,538,53,3,1,0,0,1,5,42,30,1,136,36,2,0,0,0,3,10,50,29,1,131,89,5,1,0,0,4,15,92,59,2,267
2AE1962922F413A3E055000000000001,ED3409_27118,Killimor,118,199,2,319,11,0,0,0,0,2,1,17,21,1,53,15,0,1,0,0,0,2,30,17,0,65,26,0,1,0,0,2,3,47,38,1,118
2AE1962922F613A3E055000000000001,ED3409_27119,Killogilleen,425,420,16,861,72,1,0,0,1,5,4,67,43,0,193,88,3,3,0,0,7,12,81,36,2,232,160,4,3,0,1,12,16,148,79,2,425
2AE19629232313A3E055000000000001,ED3409_27120,Kilmeen,253,358,7,618,28,0,1,0,0,0,5,50,23,1,108,49,0,3,0,0,2,11,56,23,1,145,77,0,4,0,0,2,16,106,46,2,253
2AE19629232F13A3E055000000000001,ED3409_27121,Kilreekill,174,141,11,326,20,3,0,0,0,3,10,24,19,0,79,29,1,2,0,0,3,5,36,19,0,95,49,4,2,0,0,6,15,60,38,0,174
2AE19629233B13A3E055000000000001,ED3409_27122,Kilteskill,194,128,8,330,29,2,1,0,1,1,3,28,28,0,93,37,0,0,0,0,4,6,37,17,0,101,66,2,1,0,1,5,9,65,45,0,194
2AE19629234913A3E055000000000001,ED3409_27123,Kiltullagh,341,362,6,709,50,0,0,1,1,7,6,43,41,3,152,75,2,0,0,0,3,8,62,37,2,189,125,2,0,1,1,10,14,105,78,5,341
2AE19629235713A3E055000000000001,ED3409_27124,Lackalea,185,181,15,381,30,2,1,0,0,1,2,27,20,1,84,39,3,0,0,0,8,4,31,16,0,101,69,5,1,0,0,9,6,58,36,1,185
2AE19629235913A3E055000000000001,ED3409_27125,Leitrim,193,259,7,459,29,0,2,0,0,0,1,25,24,2,83,45,1,1,2,0,2,3,35,21,0,110,74,1,3,2,0,2,4,60,45,2,193
2AE19629238D13A3E055000000000001,ED3409_27127,Loughrea Rural,418,416,3,837,58,3,1,0,1,1,9,59,38,0,170,84,1,2,0,0,4,18,98,41,0,248,142,4,3,0,1,5,27,157,79,0,418
2AE19629238E13A3E055000000000001,ED3409_27128,Loughrea Urban,"1,940","3,130",171,"5,241",253,10,1,3,0,17,60,315,172,11,842,339,15,2,0,0,21,82,399,238,2,"1,098",592,25,3,3,0,38,142,714,410,13,"1,940"
2AE1962923AB13A3E055000000000001,ED3409_27130,Mountain,130,136,4,270,18,0,0,0,0,1,5,24,18,0,66,15,0,1,0,0,2,8,20,16,2,64,33,0,1,0,0,3,13,44,34,2,130
2AE1962922DC13A3E055000000000001,ED3409_27131,Movode,122,119,9,250,20,1,0,0,0,2,6,10,14,0,53,16,0,0,0,0,2,9,21,21,0,69,36,1,0,0,0,4,15,31,35,0,122
2AE1962922ED13A3E055000000000001,ED3409_27132,Raford,186,268,5,459,33,0,2,0,0,3,4,28,16,2,88,30,0,3,0,0,0,8,41,15,1,98,63,0,5,0,0,3,12,69,31,3,186
2AE19629233213A3E055000000000001,ED3409_27133,Tiaquin,339,331,9,679,53,1,1,0,0,2,3,47,39,0,146,71,1,3,0,0,6,11,61,39,1,193,124,2,4,0,0,8,14,108,78,1,339
2AE19629235013A3E055000000000001,ED3409_27134,Woodford,153,293,3,449,15,0,0,0,0,0,6,28,20,1,70,27,0,0,1,1,1,0,36,17,0,83,42,0,0,1,1,1,6,64,37,1,153
2AE19629204E13A3E055000000000001,ED3409_27135,Annagh,152,199,7,358,18,2,1,0,0,2,0,27,14,1,65,27,0,0,0,0,1,4,30,24,1,87,45,2,1,0,0,3,4,57,38,2,152
2AE19629208B13A3E055000000000001,ED3409_27136,Ballynakill,282,292,4,578,34,0,1,0,0,2,8,47,34,0,126,49,0,0,0,0,1,9,58,38,1,156,83,0,1,0,0,3,17,105,72,1,282
2AE1962920BD13A3E055000000000001,ED3409_27137,Caltra,193,160,2,355,26,1,0,0,0,2,6,30,31,1,97,31,1,1,0,0,3,5,36,19,0,96,57,2,1,0,0,5,11,66,50,1,193
2AE1962920D713A3E055000000000001,ED3409_27138,Castleblakeney,249,245,8,502,41,0,0,0,0,2,5,46,28,0,122,29,1,0,0,0,5,3,55,34,0,127,70,1,0,0,0,7,8,101,62,0,249
2AE1962920E013A3E055000000000001,ED3409_27139,Castleffrench,247,253,5,505,38,1,0,2,0,2,7,26,36,0,112,45,1,0,0,0,1,12,41,35,0,135,83,2,0,2,0,3,19,67,71,0,247
2AE19629210413A3E055000000000001,ED3409_27140,Clonbrock,268,278,4,550,26,0,0,0,0,5,8,38,39,0,116,32,1,0,0,0,2,10,62,45,0,152,58,1,0,0,0,7,18,100,84,0,268
2AE19629204A13A3E055000000000001,ED3409_27141,Cloonkeen,156,127,4,287,9,0,0,0,0,1,4,29,20,0,63,34,0,0,0,0,0,9,31,18,1,93,43,0,0,0,0,1,13,60,38,1,156
2AE1962922E513A3E055000000000001,ED3409_27142,Cooloo,268,242,5,515,43,0,1,1,0,3,4,44,28,2,126,50,0,1,0,0,3,7,40,40,1,142,93,0,2,1,0,6,11,84,68,3,268
2AE19629230413A3E055000000000001,ED3409_27143,Derryglassaun,368,439,9,816,42,1,0,1,0,1,9,55,57,1,167,50,1,0,0,0,7,12,71,59,1,201,92,2,0,1,0,8,21,126,116,2,368
2AE1962922E813A3E055000000000001,ED3409_27144,Killeroran,562,674,18,"1,254",86,2,1,3,0,4,12,92,69,0,269,96,1,0,1,0,5,16,102,71,1,293,182,3,1,4,0,9,28,194,140,1,562
2AE1962922E913A3E055000000000001,ED3409_27145,Killian,180,146,6,332,20,0,1,0,0,2,8,32,22,3,88,30,0,0,0,0,2,7,31,19,3,92,50,0,1,0,0,4,15,63,41,6,180
2AE1962923AA13A3E055000000000001,ED3409_27146,Mount Bellew,906,918,13,"1,837",125,2,0,2,0,7,21,159,82,5,403,153,2,0,1,0,4,30,209,102,2,503,278,4,0,3,0,11,51,368,184,7,906
2AE1962922D013A3E055000000000001,ED3409_27147,Mounthazel,218,277,5,500,24,0,2,0,0,2,10,38,23,0,99,42,0,2,0,0,4,6,46,19,0,119,66,0,4,0,0,6,16,84,42,0,218
2AE19629232713A3E055000000000001,ED3409_27148,Taghboy,106,103,1,210,13,0,0,0,0,1,1,12,16,0,43,12,0,0,1,0,0,11,26,13,0,63,25,0,0,1,0,1,12,38,29,0,106
2AE1962920BE13A3E055000000000001,ED3409_27149,Camas,288,16,3,307,29,18,1,0,0,90,6,0,0,1,145,40,18,0,0,0,77,7,1,0,0,143,69,36,1,0,0,167,13,1,0,1,288
2AE19629204913A3E055000000000001,ED3409_27150,An Fhairche,658,413,16,"1,087",70,3,1,1,1,37,32,104,36,5,290,140,10,0,2,0,32,52,99,29,4,368,210,13,1,3,1,69,84,203,65,9,658
2AE1962922F113A3E055000000000001,ED3409_27152,An Cromp�n,"2,212",153,27,"2,392",238,165,3,1,0,599,32,30,1,10,"1,079",230,199,1,2,0,595,40,47,6,13,"1,133",468,364,4,3,0,"1,194",72,77,7,23,"2,212"
2AE1962922F313A3E055000000000001,ED3409_27153,An Chorr,111,52,1,164,7,2,0,0,0,9,10,28,5,0,61,7,0,0,0,0,8,5,25,5,0,50,14,2,0,0,0,17,15,53,10,0,111
2AE19629234613A3E055000000000001,ED3409_27154,Garmna,"1,177",54,13,"1,244",98,110,1,0,0,371,9,12,1,8,610,116,106,0,0,0,312,15,11,1,6,567,214,216,1,0,0,683,24,23,2,14,"1,177"
2AE1962923A413A3E055000000000001,ED3409_27155,Cill Chuim�n,91,51,2,144,11,4,0,0,0,20,2,5,4,2,48,7,3,0,0,0,17,4,6,5,1,43,18,7,0,0,0,37,6,11,9,3,91
2AE19629236B13A3E055000000000001,ED3409_27156,Leitir Breac�in,71,136,6,213,6,1,0,0,0,4,3,17,5,0,36,6,2,0,0,0,2,4,13,8,0,35,12,3,0,0,0,6,7,30,13,0,71
2AE19629236C13A3E055000000000001,ED3409_27157,Letterfore,94,154,7,255,12,0,0,0,0,3,2,25,4,1,47,10,0,0,0,0,3,6,16,12,0,47,22,0,0,0,0,6,8,41,16,1,94
2AE19629236D13A3E055000000000001,ED3409_27158,Leitir M�ir,762,46,5,813,76,80,2,0,0,215,5,5,0,4,387,71,75,2,0,0,205,12,9,0,1,375,147,155,4,0,0,420,17,14,0,5,762
2AE1962922E013A3E055000000000001,ED3409_27159,Oughterard,"1,111","1,366",54,"2,531",120,6,1,2,1,43,50,216,84,2,525,133,13,3,2,1,47,75,199,111,2,586,253,19,4,4,2,90,125,415,195,4,"1,111"
2AE19629234113A3E055000000000001,ED3409_27161,An Turlach,474,59,1,534,61,34,0,0,0,141,5,10,1,4,256,50,36,0,0,0,115,5,9,1,2,218,111,70,0,0,0,256,10,19,2,6,474
2AE19629235113A3E055000000000001,ED3409_27162,Wormhole,"1,170","1,093",22,"2,285",172,8,5,4,0,32,37,207,79,0,544,220,11,2,0,2,24,68,220,78,1,626,392,19,7,4,2,56,105,427,157,1,"1,170"
2AE19629210213A3E055000000000001,ED3409_27163,Abbeyville,105,160,1,266,7,0,1,0,0,0,2,15,12,0,37,18,0,2,0,0,1,4,22,20,1,68,25,0,3,0,0,1,6,37,32,1,105
2AE19629207513A3E055000000000001,ED3409_27164,Ballyglass,69,99,2,170,5,0,0,0,0,0,0,17,9,0,31,11,2,1,0,1,0,4,12,7,0,38,16,2,1,0,1,0,4,29,16,0,69
2AE19629230213A3E055000000000001,ED3409_27166,Derrew,74,78,7,159,12,0,0,0,0,0,0,10,10,0,32,10,0,1,0,0,1,1,22,7,0,42,22,0,1,0,0,1,1,32,17,0,74
2AE19629232113A3E055000000000001,ED3409_27167,Drummin,152,203,6,361,19,0,0,0,0,1,3,22,21,0,66,23,0,0,0,0,3,7,40,13,0,86,42,0,0,0,0,4,10,62,34,0,152
2AE19629232D13A3E055000000000001,ED3409_27168,Eyrecourt,167,261,7,435,15,0,1,0,0,0,3,22,22,2,65,28,0,2,0,0,1,6,38,27,0,102,43,0,3,0,0,1,9,60,49,2,167
2AE1962922EA13A3E055000000000001,ED3409_27169,Killimor,230,442,6,678,25,0,0,1,1,0,9,29,32,0,97,31,0,1,1,0,0,9,59,32,0,133,56,0,1,2,1,0,18,88,64,0,230
2AE19629231713A3E055000000000001,ED3409_27170,Kilmalinoge,106,120,2,228,14,0,1,0,0,0,2,19,13,0,49,17,0,1,1,0,1,1,15,21,0,57,31,0,2,1,0,1,3,34,34,0,106
2AE19629232513A3E055000000000001,ED3409_27171,Kilquain,106,185,2,293,11,0,0,0,0,0,2,13,17,1,44,13,0,0,0,0,0,1,31,16,1,62,24,0,0,0,0,0,3,44,33,2,106
2AE19629239A13A3E055000000000001,ED3409_27172,Meelick,122,139,1,262,25,0,0,0,0,1,3,15,19,1,64,20,0,0,0,0,0,1,23,12,2,58,45,0,0,0,0,1,4,38,31,3,122
2AE19629239C13A3E055000000000001,ED3409_27173,Moat,45,99,0,144,6,0,0,0,0,0,2,6,4,0,18,11,0,0,0,0,0,2,6,8,0,27,17,0,0,0,0,0,4,12,12,0,45
2AE1962922EB13A3E055000000000001,ED3409_27174,Pallas,167,216,4,387,27,1,0,0,0,0,5,19,18,3,73,27,1,1,0,0,2,5,35,22,1,94,54,2,1,0,0,2,10,54,40,4,167
2AE1962922EC13A3E055000000000001,ED3409_27175,Portumna,785,"1,358",34,"2,177",81,2,5,1,0,5,25,147,80,5,351,107,0,1,2,0,8,22,180,109,5,434,188,2,6,3,0,13,47,327,189,10,785
2AE19629233313A3E055000000000001,ED3409_27176,Tiranascragh,85,82,1,168,11,0,1,0,0,2,4,10,12,0,40,10,0,1,0,0,0,3,12,17,2,45,21,0,2,0,0,2,7,22,29,2,85
2AE19629234F13A3E055000000000001,ED3409_27177,Tynagh,175,258,2,435,28,0,2,0,0,2,5,32,13,0,82,37,1,1,0,0,2,4,30,16,2,93,65,1,3,0,0,4,9,62,29,2,175
2AE1962920FF13A3E055000000000001,ED3409_27178,Abbey East,254,348,10,612,33,0,0,0,1,1,8,36,43,0,122,33,0,3,0,0,1,8,44,43,0,132,66,0,3,0,1,2,16,80,86,0,254
2AE19629210013A3E055000000000001,ED3409_27179,Abbey West,271,437,14,722,32,0,0,1,0,3,9,54,24,0,123,42,0,0,0,0,7,13,48,38,0,148,74,0,0,1,0,10,22,102,62,0,271
2AE19629204613A3E055000000000001,ED3409_27180,Addergoole,236,289,3,528,31,0,0,0,0,1,8,37,37,1,115,26,0,0,3,0,1,6,49,32,4,121,57,0,0,3,0,2,14,86,69,5,236
2AE19629205913A3E055000000000001,ED3409_27181,Annaghdown,605,689,18,"1,312",79,4,3,0,0,7,32,100,58,4,287,100,1,2,0,0,9,33,120,52,1,318,179,5,5,0,0,16,65,220,110,5,605
2AE19629205F13A3E055000000000001,ED3409_27182,Ballinderry,228,225,15,468,33,0,1,1,1,2,8,37,22,1,106,33,0,0,0,2,2,15,43,27,0,122,66,0,1,1,3,4,23,80,49,1,228
2AE19629206813A3E055000000000001,ED3409_27183,Ballinduff,327,363,11,701,39,2,1,0,2,8,5,54,46,0,157,54,2,1,0,0,5,14,58,35,1,170,93,4,2,0,2,13,19,112,81,1,327
2AE19629208E13A3E055000000000001,ED3409_27184,Ballynapark,466,546,24,"1,036",69,1,1,0,0,4,13,54,45,3,190,112,1,0,0,1,1,20,85,52,4,276,181,2,1,0,1,5,33,139,97,7,466
2AE1962920A313A3E055000000000001,ED3409_27185,Beaghmore,143,187,19,349,30,1,0,2,0,3,4,25,6,0,71,25,0,0,0,0,5,2,24,15,1,72,55,1,0,2,0,8,6,49,21,1,143
2AE1962920A413A3E055000000000001,ED3409_27186,Belclare,321,400,8,729,56,2,0,0,1,3,13,46,28,0,149,55,1,0,0,1,5,17,58,35,0,172,111,3,0,0,2,8,30,104,63,0,321
2AE1962920CD13A3E055000000000001,ED3409_27187,Carrownagur,181,250,2,433,39,0,0,0,0,0,2,25,21,2,89,32,0,0,0,2,2,1,27,27,1,92,71,0,0,0,2,2,3,52,48,3,181
2AE1962920D613A3E055000000000001,ED3409_27188,Carrowrevagh,190,217,15,422,25,0,0,0,0,5,5,33,28,0,96,27,0,0,0,1,2,8,30,26,0,94,52,0,0,0,1,7,13,63,54,0,190
2AE1962920F213A3E055000000000001,ED3409_27189,Claretuam,462,472,89,"1,023",65,0,0,0,0,5,11,94,42,1,218,71,4,0,0,0,8,10,86,63,2,244,136,4,0,0,0,13,21,180,105,3,462
2AE19629210313A3E055000000000001,ED3409_27190,Clonbern,164,183,10,357,21,0,0,0,0,0,6,41,16,0,84,29,2,0,0,0,2,4,28,14,1,80,50,2,0,0,0,2,10,69,30,1,164
2AE19629205413A3E055000000000001,ED3409_27191,Cloonkeen,195,244,11,450,29,0,2,0,0,1,3,29,28,2,94,20,0,1,0,0,1,7,42,30,0,101,49,0,3,0,0,2,10,71,58,2,195
2AE1962922F213A3E055000000000001,ED3409_27192,Cummer,486,563,49,"1,098",74,2,3,0,0,9,10,69,51,2,220,106,1,0,0,0,7,16,91,44,1,266,180,3,3,0,0,16,26,160,95,3,486
2AE19629231213A3E055000000000001,ED3409_27193,Donaghpatrick,231,275,17,523,31,0,0,0,0,1,6,45,24,1,108,38,0,0,0,1,2,11,45,26,0,123,69,0,0,0,1,3,17,90,50,1,231
2AE19629231313A3E055000000000001,ED3409_27194,Doonbally,300,288,7,595,41,0,2,0,0,5,7,43,35,2,135,63,1,1,1,0,4,9,59,27,0,165,104,1,3,1,0,9,16,102,62,2,300
2AE19629232213A3E055000000000001,ED3409_27195,Dunmore North,233,302,11,546,33,0,1,0,0,1,12,38,24,0,109,38,2,1,0,0,3,3,45,30,2,124,71,2,2,0,0,4,15,83,54,2,233
2AE19629232B13A3E055000000000001,ED3409_27196,Dunmore South,361,437,7,805,53,0,0,1,0,4,15,59,28,0,160,55,0,1,0,0,6,13,81,44,1,201,108,0,1,1,0,10,28,140,72,1,361
2AE19629232E13A3E055000000000001,ED3409_27197,Foxhall,292,303,13,608,36,0,0,0,0,0,6,50,41,1,134,39,0,0,0,0,4,11,58,45,1,158,75,0,0,0,0,4,17,108,86,2,292
2AE19629235513A3E055000000000001,ED3409_27198,Headford,640,775,56,"1,471",74,0,1,0,0,7,22,100,76,2,282,110,4,1,2,0,10,18,140,72,1,358,184,4,2,2,0,17,40,240,148,3,640
2AE19629235613A3E055000000000001,ED3409_27199,Hillsbrook,310,347,6,663,42,2,1,0,0,0,7,60,27,4,143,56,2,1,0,0,1,3,62,40,2,167,98,4,2,0,0,1,10,122,67,6,310
2AE19629237D13A3E055000000000001,ED3409_27200,Kilbennan,181,153,8,342,22,2,0,0,0,2,2,42,20,2,92,19,2,0,0,0,1,7,40,18,2,89,41,4,0,0,0,3,9,82,38,4,181
2AE19629239913A3E055000000000001,ED3409_27201,Kilcoona,262,354,6,622,38,6,0,1,0,4,9,44,23,3,128,41,2,0,0,0,9,7,54,21,0,134,79,8,0,1,0,13,16,98,44,3,262
2AE1962922CD13A3E055000000000001,ED3409_27202,Killeany,263,309,14,586,34,2,1,3,0,3,6,50,19,0,118,35,1,0,1,0,6,9,63,28,2,145,69,3,1,4,0,9,15,113,47,2,263
2AE1962922CF13A3E055000000000001,ED3409_27203,Killeen,348,319,7,674,38,2,1,0,0,7,4,66,39,1,158,61,2,0,0,0,1,14,69,42,1,190,99,4,1,0,0,8,18,135,81,2,348
2AE1962922DB13A3E055000000000001,ED3409_27204,Killererin,363,380,2,745,44,1,1,2,0,1,11,57,40,0,157,53,0,0,0,0,3,13,80,56,1,206,97,1,1,2,0,4,24,137,96,1,363
2AE19629230513A3E055000000000001,ED3409_27205,Killower,429,405,23,857,61,0,3,1,0,6,13,61,41,1,187,81,2,2,0,0,7,7,82,60,1,242,142,2,5,1,0,13,20,143,101,2,429
2AE19629231513A3E055000000000001,ED3409_27206,Killursa,476,606,14,"1,096",75,3,1,1,1,5,15,77,39,1,218,75,4,2,2,0,5,17,106,45,2,258,150,7,3,3,1,10,32,183,84,3,476
2AE19629232413A3E055000000000001,ED3409_27207,Kilmoylan,488,527,7,"1,022",69,4,2,1,0,8,9,83,47,2,225,94,2,1,1,0,7,8,96,53,1,263,163,6,3,2,0,15,17,179,100,3,488
2AE19629233013A3E055000000000001,ED3409_27208,Kilshanvy,177,180,12,369,25,1,0,0,0,1,9,26,26,0,88,26,3,0,0,0,3,5,32,20,0,89,51,4,0,0,0,4,14,58,46,0,177
2AE19629236E13A3E055000000000001,ED3409_27209,Levally,133,206,4,343,22,0,0,0,0,1,1,24,10,0,58,27,0,0,0,0,1,3,30,14,0,75,49,0,0,0,0,2,4,54,24,0,133
2AE19629239B13A3E055000000000001,ED3409_27210,Milltown,308,323,4,635,28,0,0,0,0,2,7,48,50,4,139,50,1,0,0,0,4,16,55,42,1,169,78,1,0,0,0,6,23,103,92,5,308
2AE1962923A913A3E055000000000001,ED3409_27211,Monivea,298,320,10,628,29,0,0,0,0,0,5,50,34,0,118,61,1,1,2,0,3,6,59,47,0,180,90,1,1,2,0,3,11,109,81,0,298
2AE1962922D213A3E055000000000001,ED3409_27212,Moyne,326,317,2,645,35,0,0,0,0,4,7,57,39,1,143,52,2,1,2,0,5,5,77,37,2,183,87,2,1,2,0,9,12,134,76,3,326
2AE19629230713A3E055000000000001,ED3409_27213,Ryehill,307,417,4,728,50,2,0,1,0,2,4,46,31,0,136,60,1,1,1,1,2,4,59,41,1,171,110,3,1,2,1,4,8,105,72,1,307
2AE19629233413A3E055000000000001,ED3409_27214,Toberadosh,147,203,2,352,28,0,1,0,0,0,1,24,17,0,71,26,1,0,0,0,0,2,22,24,1,76,54,1,1,0,0,0,3,46,41,1,147
2AE19629233E13A3E055000000000001,ED3409_27215,Tuam Rural,"2,126","3,368",240,"5,734",331,11,2,6,0,19,53,302,195,7,926,418,12,7,3,3,43,62,382,264,6,"1,200",749,23,9,9,3,62,115,684,459,13,"2,126"
2AE19629233F13A3E055000000000001,ED3409_27216,Tuam Urban,"1,179","2,031",135,"3,345",128,2,2,1,2,13,29,203,121,0,501,176,6,5,2,0,15,48,272,150,4,678,304,8,7,3,2,28,77,475,271,4,"1,179"
